A	AH
A(2)	EY
ALARM	AH L AA R M
AMAZING	AH M EY Z IH NG
CLOCK	K L AA K
COOL	K UW L
DO	D UW
GUEST	G EH S T
IMPRESS	IH M P R EH S
ME	M IY
MUSIC	M Y UW Z IH K
MY	M AY
PICTURE	P IH K CH ER
PLAY	P L EY
PLEASE	P L IY Z
RUN	R AH N
SAY	S EY
SOMETHING	S AH M TH IH NG
TAKE	T EY K
THE	DH AH
THE(2)	DH IY
UP	AH P
WAKE	W EY K
